```
City/Municipality                  | City/Municipality
-----------------------------------|-----------------------------------
Archennes                          | Autre-Église
Baisy-Thy                          | Baulers
Beauvechain                        | Bierges
Bierghes                           | Biez
Bomal                              | Bonlez
Bornival                           | Bossut-Gottechain
Bousval                            | Braine-l'Alleud
Braine-le-Château                  | Céroux-Mousty
Chastre-Villeroux-Blanmont         | Chaumont-Gistoux
Clabecq                            | Corbais
Corroy-le-Grand                    | Cortil-Noirmont
Court-Saint-Étienne                | Couture-Saint-Germain
Dion-le-Mont                       | Dion-le-Val
Dongelberg                         | Énines
Folx-les-Caves                     | Geest-Gérompont-Petit-Rosière
Genappe                            | Gentinnes
Genval                             | Glabais
Glimes                             | Grand-Rosière-Hottomont
Grez-Doiceau                       | Hamme-Mille
Haut-Ittre                         | Hévillers
Houtain-le-Val                     | Huppaye
Incourt                            | Ittre
Jandrain-Jandrenouille             | Jauche
Jauchelette                        | Jodoigne
Jodoigne-Souveraine                | L'Écluse
La Hulpe                           | Lasne-Chapelle-Saint-Lambert
Lathuy                             | Lillois-Witterzée
Limal                              | Limelette
Linsmeau                           | Longueville
Loupoigne                          | Mélin
Malèves-Sainte-Marie-Wastines      | Maransart
Marbais                            | Marilles
Mellery                            | Monstreux
Mont-Saint-André                   | Mont-Saint-Guibert
Neerheylissem                      | Nethen
Nivelles                           | Nil-Saint-Vincent-Saint-Martin
Nodebais                           | Noduwez
Ohain                              | Oisquercq
Ophain-Bois-Seigneur-Isaac         | Opheylissem
Opprebais                          | Orbais
Orp-le-Grand                       | Ottignies
Perwez                             | Piétrain
Piétrebais                         | Plancenoit
Quenast                            | Ramillies-Offus
Rixensart                          | Rebecq
Rosières                           | Roux-Miroir
Saintes                            | Saint-Géry
Sart-Dames-Avelines                | Saint-Jean-Geest
Saint-Remy-Geest                   | Thines
Thorembais-les-Béguines            | Thorembais-Saint-Trond
Tilly                              | Tourinnes-la-Grosse
Tourinnes-Saint-Lambert            | Tubize
Vieux-Genappe                      | Villers-la-Ville
Virginal-Samme                     | Walhain-Saint-Paul
Waterloo                           | Wauthier-Braine
Wavre                              | Ways
Zétrud-Lumay                       | 
```